   ####################################################################################################################################################
         #        #     #                 #     #           #           #     #     #     #     #        #        #  #     #  #     #     #        #  #
#  ####  ####  ####  #  #######  ####  #  ####  ####  #  ####  ##########  #######  #  #  #  #######  #  #  ####  #  ####  #  #  #  ####  #  #  ####  #
#  #                 #  #  #        #  #  #           #     #  #              #     #  #        #  #  #  #  #        #     #     #  #        #        #
#  ####  ################  #######  #  #  ####  #############  ####  #  ####  ####  #  ####  ####  #  #  #  ####  #  #  #  #  #  #  ####  #  #######  #
#     #              #        #     #  #     #  #     #           #  #     #  #  #     #  #  #        #        #  #  #  #     #  #  #     #     #     #
#  #############  #  #  #  ####  #  ####  #  #  ####  #  #######  #  ##########  #######  #  #  #  #######  #  #  ##########  ####  #  ####  #  #######
#  #  #  #     #  #  #  #     #  #  #  #  #        #  #        #                       #        #  #  #     #  #        #        #  #  #     #  #     #
#  #  #  ####  ####  #  #  #  #######  #  #  #  ####  #  #######  ##########  #############  ####  #  ####  ##########  ##########  #  ####  #######  #
#  #        #        #  #  #  #           #  #  #        #  #     #     #  #                 #     #     #  #        #           #        #           #
#  #######  #  #  #  #  ####  #######  #######  #  #  ####  #  #  #  ####  ####  #######  #######  #  #  #  #  #######  ##########  #############  ####
#  #     #     #  #        #        #     #     #  #  #  #  #  #  #  #     #           #  #     #     #  #  #  #     #        #  #              #     #
#######  #######  #############  ####  #  #  #  #######  #  ####  #  #  #  ################  ####  ##########  ####  #######  #  #  #  ####  ####  #  #
#           #  #        #  #        #  #  #  #  #           #           #        #  #     #        #  #              #     #  #  #  #  #     #  #  #  #
##########  #  #  ####  #  #  #  #  #  ###################  ####  #  #############  #  #######  ####  #  ####  #  ####  #  ####  ####  #######  #  #  #
#  #           #     #     #  #  #     #        #     #        #  #        #                                #  #  #  #  #           #        #     #  #
#  ####  #  #  #######  ##########  #  #  #  ####  #  #######  #######  ##########  ###################  #  #  #  #  ##########  #######  #######  #  #
#     #  #  #  #        #        #  #     #     #  #  #                 #  #        #  #     #  #        #  #  #  #     #  #     #        #  #  #  #  #
#  #  #  ####  ################  ####  ##########  #  ####  #######  ####  #  #  #  #  ####  #  #######  #  #  #  #  ####  ####  ####  ####  #  #  ####
#  #     #  #        #              #     #     #  #           #     #  #  #  #  #  #  #  #  #  #        #  #  #     #  #  #  #  #              #     #
####  ####  ####  #  #######  #######  #  ####  ##########  #######  #  #  #  #######  #  #  #  #  ####  #  ####  ####  #  #  #  #  #############  #  #
#  #     #        #  #           #  #  #  #     #     #  #  #        #  #              #  #     #     #  #  #        #  #  #              #     #  #  #
#  ####  #  ####  #  ##########  #  #  ####  #######  #  ####  #  #  #  #############  #  #  #######  ################  #  ####  #  ##########  #######
#        #  #     #  #           #  #  #  #     #     #        #  #  #        #  #     #  #  #        #           #        #  #  #        #           #
#  #  ####  #############  #######  #  #  #  ####  ####  #############  ####  #  ####  #  #  ###################  #######  #  #######  ####  #  #  ####
#  #     #                 #     #              #                       #        #        #     #        #                 #  #              #  #     #
####  ####  #  #  #  ####  ####  ####  #  ####  #  #######  #######  ####  ##########  #  #  #  #  #  #  #  #######  #######  #  ##########  ##########
#     #  #  #  #  #  #           #     #  #  #  #  #     #  #        #  #  #  #  #     #  #  #     #  #  #  #           #  #           #  #     #     #
#######  ##########  #  ####  ##########  #  #  #  #  ####  ####  ####  #  #  #  ####  ##########  #  #  #  #  ####  ####  ####  #######  #  #######  #
#     #        #     #  #     #     #  #  #              #  #  #     #  #     #  #  #     #     #  #  #  #  #  #           #           #        #     #
#  #  ####  ####  ##########  #  #  #  #  #  ####  #######  #  #######  #######  #  #  ####  #######  ####  #######  #######  ################  #  ####
#  #        #              #  #  #     #  #  #        #     #  #                       #     #           #  #  #  #  #        #     #                 #
#######  #  ####  ####  #######  #  #  ################  #  #  #  ####  ####  #############  #  #  ####  ####  #  #  ####  ####  #  ####  #  #  #######
#  #  #  #     #  #  #     #     #  #  #     #  #        #  #     #     #              #        #  #              #              #  #     #  #  #     #
#  #  #  ####  ####  #  #  ####  ##########  #  #  #  #  ##########  #######  ####  ####  ####  ####  ##########  #  ##########  ##########  #######  #
#  #     #     #     #  #        #  #  #     #     #  #        #  #  #     #  #  #        #  #  #        #        #  #              #           #  #  #
#  #  ####  ####  #  #  ####  ####  #  #  #  #  #######  #  ####  #  ####  #  #  ####  #  #  #  ####  #######  #######  #######  #  ##########  #  #  #
#  #  #        #  #        #  #     #     #           #  #  #  #  #        #  #     #  #  #  #  #  #        #  #     #     #  #  #           #  #     #
#  #  #######  #  ####  #######  #  #  #######  ####  ####  #  #  #  #############  #  ####  ####  ####  ####  ####  #  ####  #############  #  ####  #
#     #              #        #  #  #  #  #  #  #  #  #  #     #     #  #              #     #           #  #     #        #     #  #     #  #        #
####  #  #######  ##########  ####  ####  #  ####  #  #  ####  #######  #######  #  #######  ##########  #  #  ####  #  ####  ####  #  #######  #######
#  #  #     #           #        #  #           #     #  #        #        #     #  #  #     #  #  #        #  #  #  #     #              #           #
#  #  ##########  #  #  ##########  ####  ##########  #  ##########  #  #############  #  ####  #  #  ####  #  #  #  #############  #  ####  #  ####  #
#  #        #  #  #  #  #  #           #     #  #  #  #  #  #        #     #  #        #     #  #  #     #  #  #        #        #  #        #  #  #  #
#  ##########  #######  #  ####  ##########  #  #  #  #  #  #  #############  ####  #  #  #  #  #  #######  #  #  ##########  ####  #  ##########  ####
#        #     #        #           #  #              #           #     #        #  #  #  #           #     #  #  #     #  #  #     #     #     #  #  #
#  #  #######  #  ################  #  #  #  ####  ####  ####  #  ####  #  ####  ####  ####  #######  #  #  #  #  #  ####  #  #######  ####  ####  #  #
#  #  #        #  #     #           #     #     #     #     #  #           #           #  #     #        #  #  #                 #  #  #     #        #
#  #######  ####  ####  ##########  #############  #  ####  #  #  ####  #  ####  #  ####  #  #  ####  #  #  ###################  #  #######  #  #  #  #
#        #     #  #           #  #  #     #     #  #     #  #  #     #  #     #  #     #     #  #     #  #  #           #                       #  #  #
#  #######  #  #  #  #  ####  #  #  #  #  #  ####  #  #######  ##########  #  #  ####  #######  ##########  #  #  #######  #############  #  #  #######
#        #  #        #     #  #     #  #     #     #     #     #           #  #     #  #           #     #  #  #        #     #     #  #  #  #  #     #
#  #######  ####  ################  #  ####  #######  #######  #  ####  #  #######  #  #######  ####  #######  ####  #######  #  #  #  #######  #  ####
#           #              #  #  #     #     #     #        #  #  #     #  #     #  #  #     #  #  #     #     #     #           #        #           #
#  #######  ####  ####  ####  #  ##########  ####  #  #############  #  ####  #######  ####  #  #  #  #  #######  #  #  ####  #######  #######  ####  #
#  #        #  #  #        #  #     #     #  #        #     #  #     #     #  #     #  #     #        #  #  #     #  #  #           #  #     #  #     #
#############  ####  #  ####  ####  #  ####  ####  #  #  #  #  #  ####  #  #  ####  ####  #######  #  ####  #  ##########  ################  #  ####  #
#  #     #           #     #  #        #  #        #     #        #     #  #        #        #  #  #     #  #           #        #        #     #  #  #
#  ####  ##########  #######  #  #  ####  #  ####  ##########  #  ####  #  #######  #######  #  ####  ####  ####  #  #######  #######  ##########  #  #
#  #        #           #  #     #        #  #        #  #     #     #  #  #           #                       #  #                       #  #        #
#  #  ####  #  ####  ####  ####  #############  ####  #  #######  ####  #######  #  #  #######  #  #######  ####  ####  ####  ####  #######  ##########
#  #  #  #     #     #     #  #     #              #     #           #  #        #  #  #        #  #  #  #  #     #     #  #     #  #  #  #           #
#  ####  ####  #######  ####  #  #  #  ##########  ####  #######  ####  #######  ####  #############  #  #  #  ####  #  #  #  #######  #  #######  ####
#                 #     #  #     #  #  #     #  #  #  #  #  #  #  #        #  #  #     #  #     #        #  #  #  #  #     #  #  #  #  #  #        #  #
#  #  #  #############  #  #  ##########  #  #  ####  #  #  #  #  #  #  ####  #######  #  ####  #  #  #######  #  ####  #######  #  #  #  #  #######  #
#  #  #                 #        #        #  #     #     #  #     #  #  #  #           #  #        #     #        #                    #     #  #  #  #
#############  #######  #  ##########  ####  #  ####  ####  #  #  ####  #  #  ####  #  #  ####  #######  ####  #############  ##########  ####  #  #  #
#           #        #        #  #     #     #     #  #        #     #     #  #     #  #        #     #  #        #              #  #  #  #  #        #
#  ####  ####  #######  ####  #  #  #############  #  ##########  ####  #  ####  #############  #  #############  #  ####  ####  #  #  #  #  #  #######
#     #  #     #  #  #  #              #  #     #  #  #     #  #  #     #              #           #     #        #  #  #  #              #           #
#######  ####  #  #  #  ####  ####  ####  #  ####  #  #  ####  #  ####  #######  #  #  #  ####  ####  #  #######  ####  #  #######  ####  #  ####  #  #
#  #              #  #  #  #     #  #           #  #     #  #     #        #  #  #  #        #        #  #     #  #  #  #  #  #     #        #     #  #
#  #  ####  ####  #  ####  #  ##########  ####  #  #  #  #  #  ####  #######  ####  #######  ####  #  #  #  #######  #  #  #  ####  ##########  #  ####
#  #  #     #        #              #     #  #        #  #     #     #        #        #     #  #  #  #           #        #     #     #  #     #     #
#  ############################  ##########  #  ####  #######  ####  ####  ####  #######  #  #  #  #############  #  #######  #######  #  #  ##########
#                       #  #     #        #     #     #        #  #     #        #     #  #     #  #  #     #     #              #  #     #           #
#  #######  #  #######  #  #  #######  #######  ####  ##########  #  #######  #  #  ####  ####  ####  ####  ####  #  #######  ####  #  #  #  #######  #
#     #  #  #  #     #  #  #     #        #  #     #           #     #     #  #  #        #                 #           #           #  #  #  #     #  #
#######  ####  ####  #  #  #  ####  #  #  #  ####  #######  #############  #############  ####  #  #  #######  ################  #######  ####  ####  #
#     #  #        #     #           #  #  #           #        #        #     #              #  #  #  #     #  #        #     #        #  #           #
####  #  ##########  #  ####  ################  #  #  ################  ####  #  #  #  #  #  #############  #######  ####  #########################  #
#           #        #  #              #     #  #  #  #     #        #           #  #  #  #     #                       #  #        #     #     #  #  #
#  #  ####  #  #######  #############  ####  #  #  #######  #  #########################  #  ####  #  #  #  ####  #  ####  #  #######  ####  #  #  #  #
#  #  #  #           #           #  #        #  #     #              #  #     #     #  #  #     #  #  #  #  #     #  #  #     #              #        #
#  ####  ####  #  #  ####  ####  #  #  #######  #  ####  #######  ####  ####  ####  #  #  ####  ################  ####  #  ####  #######  ####  #######
#     #        #  #     #  #        #  #  #  #  #     #     #  #  #                 #     #     #        #     #  #                 #  #     #  #  #  #
#  #  #  ####  #############  #  ####  #  #  #  #  ####  ####  ####  #  ##########  #######  ####  #  #######  #  #  #############  #  #  #  ####  #  #
#  #  #  #        #  #        #              #  #  #  #           #  #  #  #        #  #  #  #     #     #           #     #     #     #  #           #
####  ####  #  #  #  ####  #  #######  ##########  #  ##########  #  #  #  ####  #  #  #  #############  #  #  ####  ####  #  ####  #  #  #  #  #######
#     #     #  #  #        #  #                                   #  #     #  #  #                 #        #     #  #     #     #  #  #  #  #     #  #
##########  #######  #  ##########  ##########  ##########  #############  #  ####  ##########  #  #############  ####  #######  ####  ##########  #  #
#  #     #  #     #  #  #        #     #           #                 #     #        #           #  #  #           #  #     #  #              #     #  #
#  #  ##########  #  #######  #  #  ##########  #  #############  #######  #  #  #  ##########  #  #  #  ##########  #  ####  ####  ####  ####  ####  #
#  #                 #     #  #           #  #  #  #           #  #  #  #  #  #  #  #  #     #  #  #        #     #        #     #  #        #     #  #
#  ####  #  ####  #######  #######  #######  ####  ##########  #  #  #  #  ####  ####  #  #  #############  ####  #######  #  ##########  ##########  #
#        #  #        #           #        #        #  #  #                    #  #  #  #  #                                      #  #     #           #
#  #  #############  #  #######  ####  #  ##########  #  #  #  ##########  #######  #  ##########  ##########  #######  ##########  #  ####  #######  #
#  #  #  #  #  #     #        #  #     #  #        #        #  #     #  #     #  #  #  #  #        #  #              #     #  #  #           #  #     #
####  #  #  #  #  #############  #  #  #  #  ##########  #  #######  #  #  #  #  #  #  #  #  #  ####  ####  ####  ####  ####  #  #  ####  #  #  #  ####
#              #  #                 #  #     #           #     #           #        #        #           #     #  #              #     #  #  #        
####################################################################################################################################################