   ##########################################################
      #     #           #     #     #           #  #        #
#  #  #  #  #######  #  #  #  ####  #  ##########  ####  #  #
#  #  #  #     #     #     #                 #           #  #
#  #######  ####  ################  #  ####  #######  #  ####
#     #        #              #  #  #  #     #        #  #  #
#  ##########  #  #  ##########  #  #  ####  #  #  #  #  #  #
#  #  #  #        #  #  #        #  #  #     #  #  #  #     #
#  #  #  #######  ####  #  ################  #  #######  #  #
#        #  #  #  #              #     #              #  #  #
#  #######  #  #  #  #############  ####  #######  #######  #
#        #  #                 #        #     #           #  #
#######  #  #  ##########  #  ####  ####  ####  #  ####  #  #
#     #  #              #  #        #     #     #     #  #  #
#  #  #  ####  #  #######  ####  #############  #  ####  ####
#  #           #  #  #  #     #  #  #        #  #  #  #     #
#  ####  ##########  #  ##########  #  #  #  #  ####  ####  #
#  #  #              #     #     #     #  #  #     #     #  #
#  #  #######  #  #  #  ####  #  ####  #  #######  ####  ####
#        #  #  #  #  #        #  #     #     #  #     #  #  #
####  ####  ##########  #######  ##########  #  ####  #  #  #
#  #        #        #     #  #  #  #     #     #  #  #     #
#  #  #  #######  #######  #  ####  ####  #  ####  #  #  ####
#  #  #     #     #                          #              #
#  #  #######  #######  #  #  ####  #  #  #  ##########  ####
#        #           #  #  #     #  #  #  #  #     #  #  #  #
####  ##########  ####  ####  ####  ####  #  ####  #  #  #  #
#           #              #  #     #  #  #        #  #     #
##########  ####  ####  ##########  #  #######  #  #  #  #  #
#              #     #  #                    #  #     #  #  #
#  #  #  #  ####  #######  #  #  ####  ###################  #
#  #  #  #     #  #     #  #  #  #        #              #  #
##########  #######  ##########  ####  #  #  ##########  ####
#  #     #        #              #  #  #        #     #  #  #
#  ####  #  ####  #  #############  ####  ####  #  #######  #
#        #  #     #     #  #  #           #        #     #  #
#  #############  #  ####  #  #  ####  ####  #  #  #  #  #  #
#           #        #        #  #  #  #  #  #  #     #  #  #
#  #######  #  #  #  #  #  ####  #  ####  #  #  #  #######  #
#  #           #  #  #  #        #           #  #           
##########################################################  
